1111111111111
10010000000C1
1000011101111
100P11E000001
1111111111111
