1111111111111
1C010000000C1
100000C111001
1P0011E100001
1111111111111
