1111111111111
1C010000000C1
100000C111C01
1P0011E100E01
1111111111111
