1111111111111
1C010000000C1
100000C111E01
1P00110100001
1111111111111
