1111111111111
100000C000C11
1000111110011
1P0011E000011
1111111111111
