111111111111
1001C00000011
1000011111001
1P0011E000001
1111111111111
